YES
---------------------------------------------------
backend_flush_after	integer	bytes
bgwriter_delay	integer	milliseconds
bgwriter_flush_after	integer	bytes
bgwriter_lru_maxpages	integer	None
bgwriter_lru_multiplier	real	None
checkpoint_completion_target	real	None
checkpoint_flush_after	integer	bytes
checkpoint_timeout	integer	milliseconds
commit_delay	integer	None
commit_siblings	integer	None
deadlock_timeout	integer	milliseconds
default_statistics_target	integer	None
effective_cache_size	integer	bytes
effective_io_concurrency	integer	None
from_collapse_limit	integer	None
join_collapse_limit	integer	None
maintenance_work_mem	integer	bytes
max_parallel_workers_per_gather	integer	None
max_wal_size	integer	bytes
max_worker_processes	integer	None
min_parallel_relation_size	integer	bytes
min_wal_size	integer	bytes
random_page_cost	real	None
seq_page_cost	real	None
shared_buffers	integer	bytes
temp_buffers	integer	bytes
wal_buffers	integer	bytes
wal_sync_method	enum	None
wal_writer_delay	integer	milliseconds
wal_writer_flush_after	integer	bytes
work_mem	integer	bytes

MAYBE
---------------------------------------------------
cpu_index_tuple_cost	real	None
cpu_operator_cost	real	None
cpu_tuple_cost	real	None
cursor_tuple_fraction	real	None
parallel_setup_cost	real	None
parallel_tuple_cost	real	None

NO
---------------------------------------------------
allow_system_table_mods	bool	None
application_name	string	None
archive_command	string	None
archive_mode	enum	None
archive_timeout	integer	milliseconds
array_nulls	bool	None
authentication_timeout	integer	milliseconds
autovacuum	bool	None
autovacuum_analyze_scale_factor	real	None
autovacuum_analyze_threshold	integer	None
autovacuum_freeze_max_age	integer	None
autovacuum_max_workers	integer	None
autovacuum_multixact_freeze_max_age	integer	None
autovacuum_naptime	integer	milliseconds
autovacuum_vacuum_cost_delay	integer	milliseconds
autovacuum_vacuum_cost_limit	integer	None
autovacuum_vacuum_scale_factor	real	None
autovacuum_vacuum_threshold	integer	None
autovacuum_work_mem	integer	bytes
backslash_quote	enum	None
block_size	integer	None
bonjour	bool	None
bonjour_name	string	None
bytea_output	enum	None
check_function_bodies	bool	None
checkpoint_warning	integer	milliseconds
client_encoding	string	None
client_min_messages	enum	None
cluster_name	string	None
config_file	string	None
constraint_exclusion	enum	None
data_checksums	bool	None
data_directory	string	None
DateStyle	string	None
db_user_namespace	bool	None
debug_assertions	bool	None
debug_pretty_print	bool	None
debug_print_parse	bool	None
debug_print_plan	bool	None
debug_print_rewritten	bool	None
default_tablespace	string	None
default_text_search_config	string	None
default_transaction_deferrable	bool	None
default_transaction_isolation	enum	None
default_transaction_read_only	bool	None
default_with_oids	bool	None
dynamic_library_path	string	None
dynamic_shared_memory_type	enum	None
enable_bitmapscan	bool	None
enable_hashagg	bool	None
enable_hashjoin	bool	None
enable_indexonlyscan	bool	None
enable_indexscan	bool	None
enable_material	bool	None
enable_mergejoin	bool	None
enable_nestloop	bool	None
enable_seqscan	bool	None
enable_sort	bool	None
enable_tidscan	bool	None
escape_string_warning	bool	None
event_source	string	None
exit_on_error	bool	None
external_pid_file	string	None
extra_float_digits	integer	None
force_parallel_mode	enum	None
fsync	bool	None
full_page_writes	bool	None
geqo	bool	None
geqo_effort	integer	None
geqo_generations	integer	None
geqo_pool_size	integer	None
geqo_seed	real	None
geqo_selection_bias	real	None
geqo_threshold	integer	None
gin_fuzzy_search_limit	integer	None
gin_pending_list_limit	integer	bytes
hba_file	string	None
hot_standby	bool	None
hot_standby_feedback	bool	None
huge_pages	enum	None
ident_file	string	None
idle_in_transaction_session_timeout	integer	milliseconds
ignore_checksum_failure	bool	None
ignore_system_indexes	bool	None
integer_datetimes	bool	None
IntervalStyle	enum	None
krb_caseins_users	bool	None
krb_server_keyfile	string	None
lc_collate	string	None
lc_ctype	string	None
lc_messages	string	None
lc_monetary	string	None
lc_numeric	string	None
lc_time	string	None
listen_addresses	string	None
lo_compat_privileges	bool	None
local_preload_libraries	string	None
lock_timeout	integer	milliseconds
log_autovacuum_min_duration	integer	milliseconds
log_checkpoints	bool	None
log_connections	bool	None
log_destination	string	None
log_directory	string	None
log_disconnections	bool	None
log_duration	bool	None
log_error_verbosity	enum	None
log_executor_stats	bool	None
log_file_mode	integer	None
log_filename	string	None
log_hostname	bool	None
log_line_prefix	string	None
log_lock_waits	bool	None
log_min_duration_statement	integer	milliseconds
log_min_error_statement	enum	None
log_min_messages	enum	None
log_parser_stats	bool	None
log_planner_stats	bool	None
log_replication_commands	bool	None
log_rotation_age	integer	milliseconds
log_rotation_size	integer	bytes
log_statement	enum	None
log_statement_stats	bool	None
log_temp_files	integer	bytes
log_timezone	string	None
log_truncate_on_rotation	bool	None
logging_collector	bool	None
max_connections	integer	None
max_files_per_process	integer	None
max_function_args	integer	None
max_identifier_length	integer	None
max_index_keys	integer	None
max_locks_per_transaction	integer	None
max_pred_locks_per_transaction	integer	None
max_prepared_transactions	integer	None
max_replication_slots	integer	None
max_stack_depth	integer	bytes
max_standby_archive_delay	integer	milliseconds
max_standby_streaming_delay	integer	milliseconds
max_wal_senders	integer	None
old_snapshot_threshold	integer	milliseconds
operator_precedence_warning	bool	None
password_encryption	bool	None
port	integer	None
post_auth_delay	integer	milliseconds
pre_auth_delay	integer	milliseconds
quote_all_identifiers	bool	None
replacement_sort_tuples	integer	None
restart_after_crash	bool	None
row_security	bool	None
search_path	string	None
segment_size	integer	bytes
server_encoding	string	None
server_version	string	None
server_version_num	integer	None
session_preload_libraries	string	None
session_replication_role	enum	None
shared_preload_libraries	string	None
sql_inheritance	bool	None
ssl	bool	None
ssl_ca_file	string	None
ssl_cert_file	string	None
ssl_ciphers	string	None
ssl_crl_file	string	None
ssl_ecdh_curve	string	None
ssl_key_file	string	None
ssl_prefer_server_ciphers	bool	None
standard_conforming_strings	bool	None
statement_timeout	integer	milliseconds
stats_temp_directory	string	None
superuser_reserved_connections	integer	None
synchronize_seqscans	bool	None
synchronous_commit	enum	None
synchronous_standby_names	string	None
syslog_facility	enum	None
syslog_ident	string	None
syslog_sequence_numbers	bool	None
syslog_split_messages	bool	None
tcp_keepalives_count	integer	None
tcp_keepalives_idle	integer	milliseconds
tcp_keepalives_interval	integer	milliseconds
temp_file_limit	integer	bytes
temp_tablespaces	string	None
TimeZone	string	None
timezone_abbreviations	string	None
trace_notify	bool	None
trace_recovery_messages	enum	None
trace_sort	bool	None
track_activities	bool	None
track_activity_query_size	integer	None
track_commit_timestamp	bool	None
track_counts	bool	None
track_functions	enum	None
track_io_timing	bool	None
transaction_deferrable	bool	None
transaction_isolation	string	None
transaction_read_only	bool	None
transform_null_equals	bool	None
unix_socket_directories	string	None
unix_socket_group	string	None
unix_socket_permissions	integer	None
update_process_title	bool	None
vacuum_cost_delay	integer	milliseconds
vacuum_cost_limit	integer	None
vacuum_cost_page_dirty	integer	None
vacuum_cost_page_hit	integer	None
vacuum_cost_page_miss	integer	None
vacuum_defer_cleanup_age	integer	None
vacuum_freeze_min_age	integer	None
vacuum_freeze_table_age	integer	None
vacuum_multixact_freeze_min_age	integer	None
vacuum_multixact_freeze_table_age	integer	None
wal_block_size	integer	None
wal_compression	bool	None
wal_keep_segments	integer	None
wal_level	enum	None
wal_log_hints	bool	None
wal_receiver_status_interval	integer	milliseconds
wal_receiver_timeout	integer	milliseconds
wal_retrieve_retry_interval	integer	milliseconds
wal_segment_size	integer	bytes
wal_sender_timeout	integer	milliseconds
xmlbinary	enum	None
xmloption	enum	None
zero_damaged_pages	bool	None


---------------------------------------------------

